seq0_cluster0	ATTACCGTGTATCCCCGCTGTTGCTAGCGTACAGGCGAACAAAGGCTCTTAATCAGGCCGGTCAGCCACTCCGTGAGATTCTGCGCGAATGCTATGCGTTCGCGATAGCCAGTTACTGTGTTACCTACATTTCGCAATGGGCTATGGCCGGG
seq1_cluster0	ATTAACGTGTATCCCCGCTGTTCCTAGCGCCCAGGCGAACAGAGGCTCTTAATCAGGCCGGACAGCCACTCCGTGAGATTGTTCGCGAATGCTATGCGTTCGCGATAGCCAGGCACTTTGTTATCTTCATTACGTAATGGGCTATGGCCGGG
seq2_cluster0	ATTACCGTGTATCCCCGCTGTTCCTAGCGTACAGGCGAACAAAGGCTCTTAATCAGACCGGACAGCCACTCCGTGAGATTCTGCGCGAATGCTATGCGTTCTCGATAGCCAGGTACTTTGTTACCCACCTGTCGGAACGGGCTATGGTCGGG
seq3_cluster0	ACTGCCGTGTATCCCCGCTGTTCCTAGCGTACAGGCGAACAAAGGCTCTTAATCAGGCCGGACAGCCACTCCGGGGGATTCTGCGCGAATGCTATGCGTTCGCGATAGCCAGGTACTTTGTTACCTACATTTAGTAATGGGCTATGGCCGGG
seq4_cluster0	ATTACCGTGTATCCTCGCTGTTGCTAGCGTACAGGCGAACAAAGGCTCTTAATCTGTCCGGAGAGCCAGTCCATGAGATTCTGCGCGAATGCTATGCGTTCGCGATAGCCAGGTAATTTGTTACCTACAGTTCGTAATGCGCTATGGCCGGG
seq5_cluster0	GTTACCGTGTATCCCCGCAGTTCGTAGCGTACAGGCGAACAAAGGCTCTTAATCAGACCGGAAAGCCACTCCGTAAGATTCTGGGCGAATGCTATGCGTTCGCGATACCCAGGTACTTTGTAACCAACATTTCGTAATGTGCTATGGCCGGG
seq6_cluster0	ATTACTGTGTATCCCCGCTGTTCCTAGCGTACAGGCGAACAAAGGCTCTTAATCAGGCCGGACAGCCACTCCGTGAGGTTCTGCGCGAATGCTATGCGTTCGCGATAGCCAGGTACTTTGTTACCTACATTTCGTAATGGGCTATGGCCGGG
seq7_cluster0	ATTACCGTGTATCCCCGCTGTTCCTAGCGGACAGCCGAACAAAGTATCTGAATGAGACCGGACAGCCACTCGGTGAGATTCTGCGCGAATGCTAGGCGATAGCGATGGCCAGGTCCTTTGTTACCTACATTTCGTAATGGGGTATGGCCGTG
seq8_cluster0	ATTACCGTGTATCCCCGCTGTTCCTATCGTACTGGCGAACTAAAGCTCTTAACCAGGCCGGACAGCCACTTCGTGAGTTTCTGCGCGAATGCTATGCGTTCGCGTTAGCCAGGTACTGTGTTACCTACAGTTCGTAATGGGCTATGGCCGGG
seq9_cluster0	ATCACCGTGTATCCCCGCTGTTCCTAGCCTACTGGCGAACTAAGGCTCTTAATCAGGCCGGACAGCCACTCCGTGAGATTGTGCGCGAATTCTATGCGTTCGCGATATCCAGGTACTTTGTTACTTACATTTTGCAATGGGAACTGGCCGGG
seq10_cluster0	AATTCCGTGAATCTTCGCTGGTCCTAGCGTACAGCCGAACAAAGGCTCTTAATCAGGCCGGACAGCCACTCCGAGGGATTCGGCGAGAATGGTATGCGTTCGCGATAACCAGGTACTTTGTTACCTACATTTCGTACTAAGCTATGGCCGGG
seq11_cluster0	ATTACCTTGTATCCCCGCTGTTCCTAGCGTACAGGCGAACAAGGGCTCTTAATCAGGCCGGACAGACACTCCCTGAGATTCTGCGCGAATGCTATGCGTTCGCGATAGCCAGCTACTTTGATACCTACATTTCGTAATGGGCTATGGCCGGG
seq12_cluster0	ATTACCGTGTATCCCCGCTGTTCCTAGCGTACAGGCGAACAAAGACTCTTAATCAGGCCCGACAGCCACTCCATGAGATTCAGCGCGAATGCTATGCGTTCGCGATAGCCAGGTACTTTGTTACCTACATTTCGTAATGGGCTATGGCCGGG
seq13_cluster0	ATTACCGTGTATCACCGCTGTTCCTAGCGTACAGGCGAACAAAGGCTCTTAATCAGGCCGGACAGCCACTCCGTGAGAATCTGCGCGAATGCTATGCGTTCGCGATAGCCAAGTACTTTGTTACCTACATTTCGTAATTGGCTATGGACGGG
seq14_cluster0	ATTACCGTGTATCCCCGCTGTTCCTAGCGTACAGGCGAACAAAGGCTTTTAATCAGGCCGGACAGCCACTCCGTGAGATTCTGCGCGAGTGCTATGCGTTCGCGATGGCCAGGGACTTTGTTACCTACATTTCGTAATGGGCTATGGCCGGG
seq15_cluster0	ATTACCGTGTAGCGCCGCTGTTCCTAGCGTACAGGCGAACAAAGGCTTTTAATGATGCCGGACAGCCACTCCGTGAGATTCTGCGCGAATGCTATGCGTTCGCGATATCCTAGTACGTTGTTACCTACATTTCGTCATGGGCTATCGCCGGG
seq16_cluster0	ATTACCGTGTATGCCGGCTGTTCCTAGCGTACAGGCGAACTAAGGCTCTTAATCAGGCCGTACAGTCACTCCGTGAGGTTCTGCGCGAATGCTATGCGTTGGTGATAGCCAGGTACTTTGTTACCTACATTTCGTAATGGGCTATGGCCTGG
seq17_cluster0	ATTACCGTGTATCCCCGCTGTGCCTAGCGTACAGGGGAACAAAGGCTCTTAATCAGGCCGGACAGCCACTCCGTGAGATTCTGCGCGAAAGCTATGCGTTCGGCATAGCCAGGTACTTTGTTACCTACATTTCGTAATGGGCTATGGCCGGG
seq18_cluster0	ATTACCGTGTATCCCCGCTGTTCCTAGTGTACAGGCGAACAATGGATGTTAATCAGGCCGGACCGCCATTCCGTGAGATTCTGCGTGAATGCTATGCGTTCGCGATAGCCAGGTACTTTGTTACCAACGTTTCTTAACGGGCTATGGCGGGG
seq19_cluster0	ATTAACGTGTATTCCCGCTGTTCCTAGCGTTCAGGCGAACAAAGGCTCTTAATCAGGCCGGACAGCCACTCCGTGAGATTCTGCGCCATTGCTATGCGTTCGCGGTAGGCAGGTACCTTGTTACCTACATTTCGTAATGGGCTATCGCCGGG
seq20_cluster1	GCTCTTGCCATTGGTTGGCAACCTTATGCGGAGTAGCGTGGAAGTTAGGAAGTTCGAAGTTACGAGTTGGCCGGTGTTTAAAAACACGAAGCAGTTGATCAAAAGTTCGATGACTGAAGTACGCCATTGGCGATGCGAACAGGACTTATACG
seq21_cluster1	GCTCGTCCCATTGGTTGGCAACCGTATGCGGAGTAGCGTCGAAGTTAGGAGGTTCGAAGGTACGAGTTGGCCGGTGTTTAAATACACGAAGCAGTTGATCAAACGTTCGATGACTGAAGTACGCCCTTGGCGATGCGAACAGGACTTAGAAG
seq22_cluster1	GCTCTTGCCATTGGTTGGCAACCATATGCGGAGTAGCGCGGAAGTTAGGAAGTTCGAAGTTACGAGTTGGCCGGTGTTTAAAAACACGAAGCAGTTGATCAAAAGTTCGATGACTGAAGTACGCCATTGGCGATGCGAACAGGACTTATACG
seq23_cluster1	GCTCTTGGCATTGGACGGCAACGTTATGCTGAGTAGCGTGGAAGTTACGAAGTTCGAAGTTACAAGTTAGACGGTGTTTAAAAAAACGAAACCGTTGATCAAAAGTTCGATGACCGAAGTACGCCATTGGCGATGCGAACAGGACTTATACG
seq24_cluster1	GCTCTTGCTATTGGTTGGCATCCTTATGCGGAGTAGCGTGGAGGTTAGGAAGTTCGAAGTTACGAGTTGACCGGGGTTTAAAAACACGAAGCAGTTGTTCAAGAGTTCGATGACTGAAGTACGCTATTGGCGATGCGAACAGGACTTATACG
seq25_cluster1	GCTCTTGCCATTGGTTGGCAACCTTATGCGGAGTAGCGTGGAAGTTAGGAAGTTCCAAGTTACGAGTTGGCCGGTGTTTCAAAACACGAAGCAGTTGATCAAAAGTTCGATGACTGAAGTACGCCATTGGCGATGCGAACAGGACTTATAAG
seq26_cluster1	GCTCTTGCCATTGGTTGCCAGCCTGATGCGAAGTAGCGTGGAAGTTAGGAACTTCGAAGTTACGAGTTGGCCGGTGTTTAAAAACACCAAGCAGTTAATCGAGAGTTCGATGACTGAAGTACGGCATTGGTGATTCGAACAGGACTCATACG
seq27_cluster1	GCTCTTGCCATTGGTTGGCAACCTTATGCGGAGTAGGGTGGAAGTTAGGAAGTTCGAAGTTACGAGTTGGCCGGTGTTTAAAAAGACGAAGTAGTTGATCAAAAGTTCGATGACTGAAGTACGCCATTGGCGAGTGGAACAGGACTTATAGG
seq28_cluster1	ACTCTGGTCATTGGTAGGCCACCATATGCGGTGTAGCGTGGAAGTTAGGAGGTTCGAAGTTATCAGTTGGCCGGTGTTTAAAAACACGAATCAGTTGATCAAAAGTTCGATGACTGAGGTACGCCATTGGCGATGCGAACAGGACTTATACG
seq29_cluster1	GCTCTTGCCATAGGTTGCCAACCTTATGCGGAGAAGCGTGGGAGTTAGGAACTTCGAAGTTACGAGTTGGCCGGTGTATAAAAACACAAAGCAGTTGATCAAAAGTTCGGTGACTGAACTACGCCCTTGGCGAAGCGAACAGGACGTATACG
seq30_cluster1	GCTCTTGCCATTGGTTGGCAACCTTATGCGGAGTAGCGTGGAAGTTAGTAAGTTCGAAGTTACGAGTTGGCCGGTGTTTCGAATCACGAAGCAGTTGATAGAAAGTTCGATGACTGAAGTACGCCATCAGAGATGCGAACAGGACTTATACG
seq31_cluster1	GCTCATGCCACTGGTTGGCAACCTTATTCGGAGTAGCGTGGAAGTTAGGAAATTCGAAGTTACGGGTTGGCCGGTGTTTAAAAACACGAAGCAGTTGATCAAAAGCTCGATTACTGAAGTACGCCATTGTCGATGTGAAAAGACCGTATACG
seq32_cluster1	GCTCATGCCATTGGTTGGCAACCTTAGGCGGAGTAGCGTGGAACTTAGGAAGTTCGAAGTTACGAGTCGGCCGGTGTTTAAAAACACGTCGCAGTTGATCAAAAGTTCAAAGACTGATGTACGCCATTGGAGATGCGAATGGGACTTATACG
seq33_cluster1	GCTCGTGCCATTGGTTTGCAACCTTATATGAAGTAACGGGGAAGTTAGGAAGTTGGAAGTTACGAGCTGGGCGGTGTTTAAAAACACGAAGCAGTTGATCAAAAGTTCGATGACTGAAGTGCGACATTGCCGATGCGAACAGGACTTATACG
seq34_cluster1	GCTCTTGCCATTGGTTGGCAACCTTATGCGGAGTAGCGTGGAAATTAGGAGGTTCGAAGTTATGAGTTGGCCGGTGTTTAAAAACACGAAGCAGTTGATCAAAAGTTCGATGACTGAAGTACGCCATTGGCCATGCGAACAGGACTTATACG
seq35_cluster1	GCGCTTGCCATTGGTTGGCAACCTAATGCGGAGTAGTGTGAAACTTAAGAAGTTCGAAGTTACGAGTTGGCCGGTGTTTAAAAACACGAAACAGTTGATCAAAAGTTCGATAACTGTAGTACGCCATTGGCGATGCGAACAGGACTTTTACG
seq36_cluster1	GCTCTTGCCATTGGTTGGCAACCTTATGCGGAGTAGCGTGGAAGTTAGGAAGTTCGAAGTTACGAGTTGGCCGGTGTTTAAAAACACGAAGCAGTTGATCAAGAGTTCGATGACTGAAGTACGCCATTGGCGATGCGAACAGGACTTATACG
seq37_cluster1	GCTCTCGCCATTGGTTGGCAACCTTATGCGGAGTAGCGTGGAAGTTAGGAAGTTCGAAGTTACGAGTTGGCGGGTGTTTAAAAACACGAAGCAGTTGATCAAAAGTTCGATGACTGAAGTACGCCATTGGCGATGCGAACAGGACTTATACG
seq38_cluster1	GCTCTTGCCATTGGTTGGCGACCTTATGCGGAGTAGCGGGGAAGTTAGGAAGTTCGAAGTTACGAGTTGGCCGGAGTTTAAAAACACCAAGCAGTTGATCAAAAGTTCGATTCCTGTAGTACGCCAGTGGCAATTCGAACAGGACTTATACG
seq39_cluster1	GATGCTCCCATCGGTTGGTAACCTTATGCGGAGTAGCGTGGAACTTAGGAAGTTCGAAGTTACGAGTTGGCCGGTGTTTAAAAACACGAAGCAGTTGATAAGAGGTTCGGTGCCTGAAGTACGCCATTGGCGCTGCGAACAGTACTTATACG
seq40_cluster2	CCCTCCTACCAGGCAATCTGAGGACGCTAGCCGTGCATAGCACACGTCTCGACCGTGTCCAGAGGGTGTGCGGTTGAGCGTAGTACAAAGTCACCCCAAAGCTAATGGGATGCACAGGTAGAATTGGGCTACAAAGAAGTCATACAGGGAGC
seq41_cluster2	CCCTCCTACCACGAAATCTGAAGACGCTAGCCATGCATAGCACATGTCTCGACCGTGTCCAGAGGGTGCGCGGCTGAGCGTAGTCCAAAGTCACCCCAAAGCTAATGGGATGCACAGGTAGAATTGTGCTACAAAGAAGTCATACAGGGTGT
seq42_cluster2	CCCCCCTACCACGTAATCTGAGGACGCTAGCCATCCATAGCACACGTCTCGACCGTGTCCATAGGGTGCGCGGCTGAGCGTAGTACAAAGTCACCTCAAAGCTAATGGGATGCACAGGTAGAATTGGGCTACAAAGAAGTCATACATGGTGT
seq43_cluster2	CCCTCCTACCACGAAATCTGAGGACGCTAGCCATGCATAGCACACGTCTCGACCGTGTCCAGAGGGTGCGCGGCTGAGCGTAGTACAAAGTCACCCCAAAGCTAATGGGATTCACAGGTAGAATTGGGCTACAAAGAAGTCATACAGGGTGT
seq44_cluster2	CCCTTCTACCTCGAAGTCTGAGGAAGCTAGCCATGCATAGCACACGTCTCGACCGTTTCGAGATGGTGCGCGGCTGATCGTAGTACAAAGTCACCCCAAAGCTAATGGGATGCACGGGTAGAATTGGGCTACAAAGAAGTCATACAGGGTGT
seq45_cluster2	CCCTCCTACCACGAAATCTGAGGACGCTAGCCATGCATAGCAGACGTCTCGACCGTGTCCAGAAGGTACGCGGCTTAGCGTAGTACAAGGTAACCCCAAAGCTAATTGGATGCATAGGTAGAATTAGGCTACAAAGAAGTCATTCAGGGTGT
seq46_cluster2	CCCTCCTAGCACGAAATCTGAGGACGCTAGCCATGTATAGCACACGTCTGGGCCGTGTGCTGAGGGTGCGCGGCTGAGCGTAGTACAAAGTCAGCCCAAAGCTAATGGGATGCCCAGGTAGAATTGGGCTACAAAGAAGTCTTATAGGGAGT
seq47_cluster2	CCCTCCTAGCACGAAATCTGAGGACGCTAGCCATGCATAGTACACGTCTCGACGGTGTCCAGAGAGTGCGCGGCTGAGCGTAGTACAAAGTCACCCCAAAGCTAATGGGATGCACAGGTAGAATTGGGCTACAAAGAAGTCATACAGGGTGT
seq48_cluster2	CCCTCCTACCACGATATCTGAGGACGCTAGCCATGCATAGCACACGTCTCGACCGTGTCCAGAGGGTGCGCGGCTGAGCGTAGTACAAAGTCACCCCAAAGCTAATGGGATGCACAGGTAGAATTGGGCTACAAAGAAGTCATACAGGGTGT
seq49_cluster2	CCCTCCTACCACGAAATCTGAGGACGCTAGCCATGCATAGCACACGTCTCGACCGTGTCCAGAGGGTGCGCGGCTGAGCGTAGTACAAAGTCACCCCAAAGCTAATGGGATGCACAGGTAGAATTGGGCTACAAAGAAGTCATACAGGGTGT
seq50_cluster2	CCCTCCTACCAGGAATTCTGAGGACGCTAGCCATGCATAGCACACGTCTCGACCGCGTCCAGTGGGTGCGCGGCTGAGCGTAGTACAATGTCACCCCAAAGCTAATGGGATGCACCGGTAGAATTGGGCTACAAAGAAGTCATACAGGGTGT
seq51_cluster2	CCCTCCTGCCACGAAATCTGAGGACGCTAGCCATGCATAGCACTCGTCTCGACCGTGTCCAGAGGGTGCGCGGCTGAGCGTAGTACAAAGTCACCACAAAGCTAATGGGATGCACAGGTAGAATTGGGCTACAAAGAAGTAATACAGGGTGT
seq52_cluster2	CCCTCCTACCACGAAATCTGAGGACGCTAACCATGCATAGCACACGTCTCGCCCGTGTCCTGAGGGTGCGCGGCTGAGCGTAGTACAAAGTCACCCCAAAGCTAATGGGATGAACACGTAGAATTGGGCTACAAAGAAGTCATACAGGGTGA
seq53_cluster2	CCCTCCTACCACGAAATCTGAGGACGCTAACCATGGATAGCGCACCTCTCAACCGTGTCCATAGGGTGCGCGGCTGAGCGTAGTACAAAGTCGCCCCAAAGCTAATGGGAGGCAGACGTAGAGTTGGGCTACAAAGAAGTAATACAGGGTCT
seq54_cluster2	CCCTCCTACCACGAAAACTGAGGACGCTAGCCATGCATAGCATACGTCTGGCCAGTGTCCAGACGGTGCGCGGCTGAGCGAAGTACAAAGTCAACCCAAAGCTAATGGGATGCACAGGTAGAATTGGGCTACAAAGAAGTCATACAGGCTGT
seq55_cluster2	CCCTCTTACCACGGCATATGAGGACGCTATCGATGCATAGCTCACGTCTCGACCGAGTCCAGAGGATGCACGGCTGAGCGTAGCGCAAAGTCACCCCAAAGCAAATGGGATGCACAGGTAGAATTGGGCTACAAAGAAGTCATCCAGGGTGT
seq56_cluster2	CCCACCTACCACGAAATCTGAGGACGCGAGCCATGCATAACACACGTCTCGACCGTGTCCAGAGGGTGCGCGGCTAAGCGTAGTACAAAGTCACCCCAAAGCTAATGAGATGTACGGGTAGAATTGGGCTACAAAGGAGTCATACAGGGTGT
seq57_cluster2	CCCACCTACCACGAAATCTGAGGACGCTAGCCATGCAGAGCACACGTCTCGACCGTGTTCAGAGGGTGCGCGCCTGAGCCTAGTACAAAGGCACCCCAAAGCCAATGGGATGCACAGGTAGAATTGGGCTACAAAGAAGTCATACAGGGTGT
seq58_cluster2	CCCTCCTACCACGAAATCTGAGGACGGTAGGCATGCATAGCACCCGTCTCGACCGTGTCCAGAGGGTGCGCGCCTGAGCCTAGTACAAAGTCAACCCAAAGCTAATGGGATGCACAGGTAGAATTGGGCTACAAAGAAGTCATACAGGGTGT
seq59_cluster2	CCCTCCTACCGCGAAATCTGAGGACGCTAGCCATGCATAGCACACTTCTCGACCGTGTCCAGAGGGTGCACGGCTGAGCGTAGTACAAAGTCACCCCACGGTTAATGGGATGCACAGGTAGAATTGGGCTACAAAGAAGTCATACAGGGTAT
seq60_cluster3	TCGTGGCGGGGGTTTAACACGTGGAGACGTTTGAGATATGCGATAACTTAGGTTACGCGAGGGAATGATGCAAGTGCAATGTGTTACAGGATCTGAATATCGACAACAGATTTACAGGACGCACCCAGCCGGGTAGGCCCTAACGTTACATC
seq61_cluster3	TGGTGGAGGGGGTTTAACACGTGGAGACGATTGAAATATGCCATAACTTAGGTTATCCGAGGGCATGATGCAAGTTCAATGTGTTACGGGATCTGAATATCCACAATAGATTCGCAGTACGCTCCCAGCTGGGTAGGCCCTAACGTTACATC
seq62_cluster3	TGGTGGAGGGGTTTTGACACGTGGAGACGATTGATATATGCCCTAACTTAGGTTATCCGAGGGCATGATGCAATTTCAACGTGTTACGGGATCTCAATATCCACAACAGATGCGCAGGTCGCTCCGAGCTGTGTAGGCCCTAACGTTACATC
seq63_cluster3	TGGTAGAGGGGGATTAACACCTGGAAACGATTGAGATGTGCCATAACTTAGGTTATCCGCGGGCATGATGAAAGTTAAATATGTTACAGGATCTGAATATCCACAACAGATTCGCAAGACGCTCACAGCTGGGTAGGCCCTAACGTTACATC
seq64_cluster3	TGGTGGAGCGGGTTTAACACGTGGAGACGATTGAGATATGCCATAACTTAGGTTATCCGAGGGCATGATGCAAGTTCAATGTGTTACGGGATCTGAATATCCACAACAGATTCGCAGGACGCTCCCAGCAGGGTAGGCCCTAACGTTACATC
seq65_cluster3	TGGTGGAGGGGGTTTAACACGTGGCGACGATTGAGATATGCCATAACTTAGGTTATCCGAGGGCATGATGCAAGTTCAATGTGTTACGGGATCTGAATATCCACAACAGATTCGCAGGACGCTCCCAGCTGGGTAGGCCCTAACGTTACATC
seq66_cluster3	TGGTGGCGGGGGTTTAACACGTGGAGACGTTTGGGATATGCCATAACTTAGGATATCCGAGGGCATGATGCAAGTTAAGTGTGTTACGGGATCTGAATATCCACAACAGATTCGCAGGACGCTCCCAGCTGCGTAGGCCCTAACGTTACATC
seq67_cluster3	TGGTGGAGGGGGTTTAACACGTGGAGACGATTGAGATATGCCATCACTTAGGTTATACGAGGGCATGATGCAAGTTCAATGTGTTACGGGTTCTGAATATCCACAACAGATTCGCAGCACGCTCCCAGCTGGGTAGGCCCTGACGTTACATC
seq68_cluster3	TGGTGGAGGGGGTTTTACTCATGGAGACGATTGAGATATGCCATAACTAAGGTGATCCGAGGGCATGATGCAAGTTCAATGTGTTACGGGATCTGAATATCCACAACAGATTCGCAAGACGCTCCCAGCTGGGTAGGCCCTAACGTTACATC
seq69_cluster3	TGGGGGAGGGGGACTAACACGTGGAGACGATTGATATATGCCATAACGTAGGTTATCCGAGGGCATGATGCAATTTCAATGGGTTACGGGCTCTGAATATCCACAACGGATTCGCACGCCGCTCCCAGCTGGCTAGGCCCTAACGCTACATC
seq70_cluster3	TGGTGGAGGGGGTTTAACACGTGGAGACGCTTGAGATATGCCATTACTTAGGTTATCCGAGGGCATGATGCAAGTTCAATGTGTTACGGGATCTGAATATCCACAACAGAATCGCAAGACGCTCCCAGCAGAGTAGGCCCTAATGTTACGTC
seq71_cluster3	TGGTGGAGGGGGTTTCACACGTAGAGACGATTGAGATATGCCATAACTTAGGTTATCCGAGGGCATGATGCAAGTTCAATGTGTTACGGGATCTGAATATCCACAACAGATTCGCAGGACGCTCCCAGCTGGGTAGGCCCTAACGTTACATC
seq72_cluster3	TGGTGGAGGGCGTTTTACACGTGGAGCTGATTGAGATATGCCAAAACTTAGGTTATCCGAGGGCATGATGCAAGTTGAATGTGTTACGGGATCTGAATATCCACAACAGATTCGCAGGGCGCTCCCAGATGGGTAGGCCATAACGTTACATC
seq73_cluster3	TGGTGTAAGGGGCTTAACACGTGGAGTCGATTGAGATAGGCCATAACTTCGGTTATCCGAGGGCATGATGCAAGTTCAATGTGTTACGGGATCTGAACTGCCACAACAGATTCAGAGGACGCTCCCCCCTCTGTAGGCCGTAACGATAAGTA
seq74_cluster3	TGGTGGAGGGGGTTTAACACGTGGAGACGATTGAGATATGCCATCACTTATGTTATCCGAGGGCATGATGCAAGTTCAATGTGTTACGGGATCTGAATATCCACCACAGATTCGCAGGACGCTGCCAGCTGGGCAGGCCCTAACGTTACATC
seq75_cluster3	TGGTCGAGTGGGTTTAACACGTGGAGACGATTGAGATATGCCATGACTTAGGTTATCCGTGGCCATGATGCAAGTTCAATGTGTTACGGGATCTGAATATCCACAACAGATTCGGAGGACGCGCGCAGCTGGGTAGGTCCTAACGTTACATC
seq76_cluster3	TGGTGGAGGGGGTTTAACACGTGGAGACGATTGAGATATGCCCTAACTTAGGTTATCCGAGGGCATGAAGCATGTTCAATGTGTTACGGGATCTGAATATCCACAACAGACTCGCAGGACGCTCCCTGGTGGGTAGGCCCTAACGTTACATC
seq77_cluster3	TGGTGGAGGGGGTTTAACACGTGGAGACGATTGAGATATGCCATAACATAGGTTATCCGAGGGCATTATGCAAGTTCAATGCGGTACGGGATCTGAATATCCACAACAGATTCGCAGAACGCTCCCAGCTGGGTAGGCCCTAACGTTAGATC
seq78_cluster3	TGGTGGACGGGGTTTAACACGTGGAGACGATTGAGATATGCCATAACTTAGGTGATCCTAGGGCATGATGCAAGTTCAATGTGTTACGGGATCTGAATATCCACAACAGATTCGCAGGACGCTCCCAGCCGGGTAGGCCCTAACGTTACATC
seq79_cluster3	TGGTGGAGGGGGTTTAACACGTGGAGACGATTGAGATATGCCATAACATAGATTATCCTAGGGCATGATACAAGTTCAATATGTTACGGGATCTGAATATCCACAACAGATTCGCTGGACGCTGCCAGCTGGGTAGGCCCTAACGTTATATC
seq80_cluster4	ATGAGGAGCACAGCCATAGAGCCTCTTCTTCTCCGAAACTACGGAAGGTGAGGTTCATTATATTTTACTCAGGCTCTCTGTGCTCAATGGACTTGTTGCGCTAGACTGAATTCGTAATCCAACTACCGTAGCTGAGGTCGAGCGTGAGAATT
seq81_cluster4	ATGAGGAGCACAGCCATAGAGCCTCTTCTGCTCAGAAACTACGGAAGGTGCGGTTCATTATATTTTACTCAGCCCCTGTTTGCTCAATGGACTTGTTACGCTAGATTGATGTCGTTATCTAACTACCGTAGCTGAGGTCGAGCGTGAGAATT
seq82_cluster4	ATGAGGAGCACAGCGATAGAGCCTCTTCTGCTCAGAAACTACGGAAGGTGCGGTTCATTATCTTTTACTCAGCCCCTGTTTGCTCAATGGACTTGTTGCGCAAGATTGATGTCGTTATCTAACTACCGTAGCTGAGGTCGAGGGTGAGAAGT
seq83_cluster4	TTGAGGAGCATAGCCATAGAGCCGCTTCTGCTCAGAACCTACGGAAGGTGCGATTCATTCTATTTTACTCAGCCCCTGTTTGGTCAATGGACATGTTGCGCTAGATTGATGTCGTTATCTAACTACCATAGCTGAGGTCGAGCGTGAGAATT
seq84_cluster4	ATGAGGAGCACAGCCATAGAGCCTCTTCTGCTCAGAACCTACGGAAGGTGCGGTTCATTATATTTTACACAGCCCCTGTTTGCTCAATGGACTTGTTGCGCTAAATTGATGTCGTTATCTAACTACCGTAGCTGAGGTCGAGCGTGAGAATT
seq85_cluster4	ATGAGGAGCACAGCCATAGAGCCCCTTCCGTTCAGAAACTACGGAAGGTGCGCTTAATGATATTTTACTCAGCCCGTGTTTGCTCAATGGACTTGTTGCGCTAGATTGATGTCGTTATCTAACTACCGTAGCTGAGGTCGAGCGCGAGAATT
seq86_cluster4	ATGAGGAGCACAGCCATAGAGCGTCTCCTGCTCAGAAACTACGGAAGGTGCGCTTTATTATATTATACTCAGCCCCTGTTCGCTCAATTGACTTGTTGCGCTAGCTTGATCTCGTTATCTAACTACCGTAACTTAGGTCGACGGTGAGAATT
seq87_cluster4	ATGAGGAGCACAGCCATAGAGCCTCGTCGGGTCAGAAACTACGGAAGGTGCGGTTCATTATATTTTACTCAGCCCCTGTGTGCTCAATGGACTTGTTGCGCTAGATTGATGTCGTTATCTAACTATCGTTGCTGAGGTCGAGCGTGAGACTT
seq88_cluster4	ACGAGGAGCACAGCGACAGAACCGCTTCTGCTCAGAAACTACGGAAGGTGCGGTTCATTATATTTTACTCAGCCCCTGGTTGCTCAAAGGACTCGTTGCGCGAGATTGGTGTCGTTATCTAACTACCGTAGCTGAGGTCGAGCGTGAGAATT
seq89_cluster4	ATGCGGAGCACAGCCATAGAGCCTCTTCTGCTCAGAAACTACGGAAAGTGCGTTTCATTATATTTTACTCAGCCCCGGTTTGCTCAATGGACTTGGTGAGATACATTGATGTCGTTATCTAAGTACCGTAGCTGAGGTCGAGCGTGAGAGTT
seq90_cluster4	ATGAGGAGGACAGCCATAGAGCCTCTTTTGCTCAGAAACCACGGAAGGTGAGGTTCATTATATTTTACTCAGCCCCTGTTTGCTCAATGGACTTGTTGTGCTAGAGTGATGTCGTTATCTAACTACCGTAGCTGAGGTCGACCGTCAGAATT
seq91_cluster4	AAGAGGAGCACAGCGAGAGAGGCTCTTCTGCTCAGAAACTACCGGAGGTGGGGTTCTTTATATTTTACCCAGCCCCTGTTTGCTCAATGGACTTGTTGCGCTAGATTGAAGTTGTTATCAAACTACCCTGGCTGAGGTCGAGCGTGAGAATT
seq92_cluster4	ATGAGTAGCACAGCCATAGAGCCCCTTCTGCTCAGAAACTACGGACGGAGCGGTACATTATATTTTCCTCAGCCCCTGTTTGCTCAATGGACCTGTTGCGCTAGATTGATTTCGTTATCTAACTACCGTAGCTGAGATCGAGCGTGAGAATT
seq93_cluster4	ATGAGGAGCACTGCCATAGAGCCTCTTCTGCTCAGAAACCACGGAAGGTGCGGTTCAGTATATTTTACTCAGCCCCTGTTTGCTCAATGGACTTGTTGCGCTAGATTGATGTCGTTATCTAACTACCGTAGCTGAGGTCGAGCGTGAGAATT
seq94_cluster4	CTGAGGAGCACAGCCATAGAGCCTCTTCTGCTCAGAAACTACGGAAGGTGCGGTTCATTATATTTTACTCAGCCCCTGTTTGCTCAATGGACTTGTTGCGCTAGATTGATTTCGTTATCTAACTACCGTAGGTGAGTTCGAGCGTGAGAATT
seq95_cluster4	ATGAGGAGCACAGCCATAGAGCCTCTTCTGCTCAGAAACTACGGAAGGTGCGGTTCATTATATTTTACTCAGCCCCTGTTTGCTCAATGGACTTGTTGCGCTAGATTGATGTCGTTATCTAACTACCGTAGCTGAGGTCGAGCGTGAGAATT
seq96_cluster4	ATGAGGAGCACAGCCATAGAGCCTCTTCTGCTCAGAAAGTACGGAAGGTGCGGTTCATTATATTTTCCTCAGCCCCTGTTTGCTCAATTGACTTGTTGCGCTAGATTGATGTCGTTATCTAACTACCGTAGCTGAGGTCGAGCGTGAGAATT
seq97_cluster4	ATGAGGAGCAAAGCCATAGAGCCTCTTCTGCTCAGAAACTGCGGAAGGTGCGGTTCATTATCTTTTACTCAGCCCCTGTCCGCTCAATGGACTTGTTGGGCTAGATTGATGTCGTTATCTAACTACCGAACTTGAGGTCGAGCGTGAGAATT
seq98_cluster4	ATGAGGAGCACAGCCAAGGAGCCTCTTCTGCTCGGAAACAACGGAAGGTGCGGTTCATTATCTTTTACTCAACCCGTGTTTGCTCATTGGACTTGTTGCGCTTGATTTATGTCGTTATCTAACTACTGTAGCAGAGGTCGAGCGTGAGAAGT
seq99_cluster4	ATGAGGAGCACAGCCATAGAGCCTCTTCTGCTTAGAAACTACGGAAGGTGCGGTTCATTATATTTTACTCAGCCCCTGTTTGCTCAATGGACTTGTTGCGCTAGATTGATGTCGTTATCTAACTACCGTAGCTGAGGTTGAGCGTGAGAATT
seq100_cluster5	GTACTTCAGAACGAAAAAATGTTGTTTAGCAGAGTTATTGACTAGCCTCAACCTTGAACTTGACGAACAATAAGCGTAGGCTTCGCCGTCTAATAATCCGTCATCAACGCGTATGGCCGGATGAGGTGCGTGGAGAGCAAATATTAGAAGTA
seq101_cluster5	GTCCCTAAGAACGAAAAAATGTGGTTTAGGAGAGTTATTGACTAGCCCTAAACCCGAAATTGACGAACAATAAGCCTAGGCTTCGTCGTCTAATAATCGGTCGGCAACGAGTCTCGACGGGTGAGGAGCGTCTAGATCAAATATTAGCAGTA
seq102_cluster5	GTCCTTCAGAACGAAAAAATGTGGTTTAGCAGAGTTATTGACTAGCCTTAAACTTGAAATTGACGAACAATAAGCGTAGACTTCGTCGTCTAATAATCCGTCACCAACGAGTCTGGACGGATGAGGTGCGTGGAGAGCACATATTAGAAGTA
seq103_cluster5	GTCGTTCTGAACGAGAAAATGTGGATTAGCAGAGTTATTGCCGAGCCTTAAACTTCAAATTCACGAACAATAAGCGTCGGCATCGTCGTCTAAACATCCGTAACCAACGGTTCTGGACGATTGAGGTGCGTGGCGAGCGGATATTAGAAGTA
seq104_cluster5	GTCCTTCGGAACGAAAAAATGTGCTTTAGCAGAGTTAAGGACTATCCTTACACTTGATATGGACGAAGAAGAAGCATAGGCTGCGTCGTCTAATAATCCGTCACCAACGAGGCTGGACGGATGAGGTGCGTGGGGAGTAAAGCTTAGAAGTA
seq105_cluster5	GTCCTTCAGAACGAAAAAATGTGGTTTAGCAGAGTTATTGACTAGCCTTAAACTTGAAATTGACGAACAATAAGCGTAGGCTTCGTCGTCTAATAATCCGTCACCAACGAGTCTGGACGGATGAGGTGCGTGGAGAGCAAATATTAGAAGTA
seq106_cluster5	GTCCTTCAGAACGAAAAAATGTGGTTTAGCAGAATTATTGACTAGCCTTAAACTTGAAATTGACGAACAATAAGCGTAGGCTTCGTCGTCGAATAATCCGTCACCAACGAGTCTGGACGGATGAGGTGCGTGGAGAGCAAATATTAGAAGTA
seq107_cluster5	GTCCTTCAGAACGAAAAAATGTGGTTTAGCGGAGTTATTGACTAGCCTTAAACTTGAAATAGGAGAACACTAAGCGTAGGCTTCGTCGTCTAATAATCCGTCACCAACGAGTCTGGACAGATGAGGTGCGGAGAGAGCAAATATTAAAAGTA
seq108_cluster5	GTCCTTCAGAACGAAAAAATGTGTTTTAGCAGAGTTATTGACCAGCCTTAAACTTGAAATTGACGAACAATAAGGGTAGGCTTCGTCGTCTAATAATCCGTCACCAACGAGTCTGGACGGATGAGGTGCATGGTGAGCAAATATTAGAAGTA
seq109_cluster5	GTCCTTCAGTACGAAAAAATGTGGTTTAGCAGAGTTATTGACTAGCCCTAAACTTGAAATTGACGAACAATAAGCGTAGGCTCCGTCGTCTAATAAGCCGTCACCAACGAGTCGGGACGCATTAGTTGCTTGGAGAGGAAATATTAGAAGTA
seq110_cluster5	GTCCTTCAGAACGAAAATATGTGGTTTAGCAGAGTTATTGACTAGCCTTAAACCTGAAATTGACGAACAATAAGCGTAGGCTTCGTCGTCTAATAATCCGTCACCAACGAGTCTGGACAGATGAGGTGCGTGGAGAGCAATTATTAGAAGTA
seq111_cluster5	GTACTTCAGAACGAAAAAATGTGGGTTAGCAGAGTTGTTGACTAGCCTTATACTTGAAATTGACGAACAATAAGCGCAGACTCCGTCGTCTAATAATCCGTCACCAACGAGTCTGGAAGGATGAGGTGCGTGGAGAGCAAATATTAGAAGTA
seq112_cluster5	CTACTTCAGAACGAAAGAATGTGGTTTAGGAGAGTTATTGACTAGCCTTAAACTTGAGATAGACGAACAATAAGCTTAGGCTTCGTCGTCTAATAATCCGTCACCAACGAGTCTGGAAGGATGAGGTGCGTGGAGAGCCAATATTAGAAGTA
seq113_cluster5	GTCCTGCAGAACGAAAGAATGTGGTTTAGCCGTGTTATTGACTAGCCTCAACCTTTAAATTGACGAACAATAAGCGTAGGCTTCATCCTCTTATAATCCGTCACCAACGAGTCCGGACGGTTTAGGTGGGTGGAGAGCAAATATTAGAAGTA
seq114_cluster5	GTCCTTCAGTACGAAAAAATGTGGTTTAGCAGACTTATTGGATACCCTTAAGCTTGAAATTGACGAACAATCAGTGTAGGCTTCCACGTCTAATAATCCGTCACCAACGAGTCTGGGCGGATGATGTGTGTGGAGAGCAAATATTAGAAGTA
seq115_cluster5	GTCCGCCAGAACGAAAAAATGTGATCTAGCAGAGCAATTGACTAGGCTCAAACTTGAAATTGACGAACAAGAAGCGCAGGCTTCGTCGAATAATAATCCGTCACCAACGAGTCTGGCTGGATGAGGTGGATGGAGAGCAAATATTAGAAGTA
seq116_cluster5	GTCCTTCAGAACGAAAAAATGTGGTTTAGCAGAGTTATTGACTAGCCCTAAACTTGAAATTGACGAACAATAAGCGTGGGCTTCGTCGTCTAATAATCCGTCACCAACGAGTCTGGACGGATGAGGTGCGTGGATAGCAAATATTAGAAGTA
seq117_cluster5	GTCCTTCAGAACGAATAAATCTGGTTTAGCAGAATTATTGACTAGCCTTAAACTTGAAATTGACCAACAATAAGCGTAGGTTTCGTCGTCTAATAATTCGTCACCAACGCGTCTGGACCGTTGAGGTGCGCGGAGAGCAAACATTAGAAGTA
seq118_cluster5	GTCCTTCAGAACGAAAAAATGTGGTCTAGCAGATTTATTGACTAACCTTAAACTTGAAATTGACCAACAATGAGCGTAGGCTTCGTCGTCTAACAATCCGTCACCAACGAGTCTGGACGGATGAGGTGCGTGGTGAGCAAGTATTAGAAGTA
seq119_cluster5	GTCCGTCAGAACGAAAAAATGTGGTTTAGCAAAGTTAATGGCTAGCCTTAAACTTGAAATTGACGAACAATAAGCGTAGGCTGCGTCGTCTAATCATCCGTCACCATCGAGTCTTGACGGATGAGGAGCGTGGAGAGCAGATATTAGAAGTA
seq120_cluster6	CATTTACACTTCTGCAAGTAGGCTATCAAAGGAAAATGTGACTAGTAACGCGTCTACGGGGTCCAGGCCTCGGCTGCGTCAGCATGAGAAAACAACCGATAGTCCTCTCAAACGTACGTGGTTTCAGTCGGTGCGCTTCCCGACCTGGTCGG
seq121_cluster6	CATTTACACTTCTGCAAGTAGACTACCAAAGGAAAATGTGACTAGTAACGCGTCTACGGGCTCCCGGCCTCGGCTGCGTCAGCATTAGAAAGAATCCGATACTCCGCTCAAGCGAACGTGGTTTCAGTCCGTGCGCTTCCCGACCTGGTCTG
seq122_cluster6	CATTTACACTTCTGCAAGCAGGCTACCAAAGGAAAATGTGACTAGAAATGCGTCTACGGGCTCCAGGGCTCGGCTGCGTCAGCATGAGTAAACAACCAATAGTCTTCTCAATCGTACTTGGTTTCAGTCGGTGCGCTTCCCGACCTTGTCTG
seq123_cluster6	CACTTACACTTCTGCAAGTAGGGTATCCAATGAAAATGTGACTAGTAACGCATCTACGGGCTCCAGGCCGCGGCTGCGTCAGCATGAGAAAACGACCGATAGTCCTCTCAAGCGTTCGTGGTTTCAGGCGGTGCGCTTCCCGACCTGGTTTG
seq124_cluster6	CATTTGCACTTCTGCAAGTAGGCGACCAAAGGAAAATGTGACTAGTTACGCGTCTACGGGATCCAGGCCTCGGCTGCGCCCGCATGAGAAAACAACCGATAGTCCTCTCAAGCGTACGTGGTTTCAGTCGGTGCGCGTCCGGACCTGGTCTG
seq125_cluster6	CATGTACACTTCTGCAAGTAGGCTACCAAAGGAAAATGTGACTAGTAACGAGTCTACGGGCTCCAGGCCTCGGCTGCGTCAGCATGAGAAAACAACCGATAGTCCTCTCAACCGTACGTGGTTTCAGTCTGTGCGCTTCCCGACCTGGTCTG
seq126_cluster6	CTTTTACACTTCTGCAAGTAGGCTACCAAAGGAAAATGTGACTAGTAATGCGTCTACGGGCTACAGGCCTCGGCTGCGTCAGCGTGACAAAACAACGGATAGTCCACTCTAACGTACGTGATTCCAGTCGGTGCGCTTACCGACCTGGTCTG
seq127_cluster6	CATTTACACTTCTGCGAGTAAGCTACCAAAGGAAAATGTGATTAGTAACGCGTCTACGGGCTCCAGGCCTCGGCTGGGTCAGCATGAGAGAACAACCGATAGTCCTCTCAAACGTACGTGGTTTCAGTCGGTGCGCTTCCCGATCTGGTCTG
seq128_cluster6	CATTTACTCTTCTGCAAGTAGGCTACCAAAGGAAAATGTAACTAGTAACGCGTCTACGCGCTCCAGGCCTCGGCTGCGTCAGCATGAGAACACAACCGATAGTCCTCTCAAACGCACGTGGTATAAGTCGGTGCGCTTCCCGCCCTGGTCTG
seq129_cluster6	CATTTACACATCTGCAAGGAGGCTACCATAGGAAAATGTGACTAGTAACGCGTCTACGGGCTCCAGGCCTCGGCTGCGTCAGCACGAGAAAACAACCGATAGTCGTCTCAAACGTACGTGGTTTCAGTCGGTCCGCTTCCCGACCTGGTCTG
seq130_cluster6	CATCTACACTTTTGCAAGTAGGCTACCAAAGGGAAATGTGACTAGTAACGCGTCTACGGGCTACAGTCCTCGGCTGCGTCAGCATGAGAAAACAACCGATAGTCCTCTCAAACGTACGTGGTTTCAGCCAGTGCGCTTCCCGACCTGGTCTG
seq131_cluster6	CATTTACACTTCTGCAGGTAGGCCACCAAAGGAAAATGTAACTAGTAACGCGTCTACGGGCTCCAGGCCTCGGCAGCACCAAGATGAGAAAACCATCGATAGTCCTCTCAAACGTACGTGGTTTCAGTTGATGCGTTTCCCGACCTGGTCTC
seq132_cluster6	CATTTACACCTCTGCAAGTAGGCTACCAAAGGAAAATGTGACTAGTAACGCGTCTACGGGCTCCAGGCCTCGGCTCCGTCAGCATGAGAAAACAACCGATAGTCCTCTCAAACGTACGTGGTTTCAGTCGGTGCGCTTCCCGACCTGGTCTG
seq133_cluster6	TATTTACACTTCTTCAAGTAGGCTACCAACGGAAAATGTGACCAGTAACGCGACTACCGGCTCCAGGCATCGGTCCCGACATCATGAGAAAACAACCTATAGTCCTCTCGAACGTACGTGGTTCCAGTCGGTACGCTTCCCGACCTGGACTG
seq134_cluster6	CGTTTATACTTCTGCAAGTAGGCTACCAAAGGAAAATGTGACTAGTAACGCGTCTACGGGTTCCAGGCCTCAGTTGCGTCAGCACGAGATAACAACCTATAGTCCGCTCAAACGTACGTGGTTTCAGTCGGTGCGCTTCCCGACCGGGTCGG
seq135_cluster6	CATTTACAATTCTCCAAGTAGCCTACCAAAAGAAAATGTGACTAGTAACGCGTCTACGGGCTCCAGGCCTCGGCTCCGTCAGCATGAGAAACCACCCGATAGTCCTCTCAAACGTACGTGGTTTCAGTCGGGGCGCTTCCCGACCTGGTCTG
seq136_cluster6	CGTTTACACTTCTGGAAGTAGGCTACCAAAGGATAAGGTGACTAGTAACGCGTCTACGGGCTCCGGGCCTCGGCTGCGTCAGCATGAGAAAACAAGAGATATTCCTTTCAAACGTACGTGGTTTCAGTTGGTGCGCTTCCCGACCTGGTCCG
seq137_cluster6	CATTTACACTTCTGCAAGTAGGCTACCAAAGGAAAATGTGACTAGTAACGCGTCTACGGGCTCCAGGCCTCGGCTGCGTCAGCATGAGAAAACAACCGATAGTCCTCTCAAACGTACGTGGTTTCAGTCGGTGCGCTTCCCGACCTGGTCTG
seq138_cluster6	CATTTACACTTCTGTATGTAGGCTACCAAAGGAAAATGTGACTAGTAACGCGTCTACGGGCTCCAGGCCTCGGCTGCGTCAGAATGAGAAAACAACCGATAGTCCTCTCAAACGTACGTGGTTTCAGTCGGTGCGCTTCCCGACCTGGTCTG
seq139_cluster6	CATTTACACTTCTGCAAGTAGGCTACCAAAGAAAAATGTGACTAGTAACGCGTCTACGGGCTCCAGGGCTCGGCTGCGTCAGCATGAGAAAACAACCGATAGTCCTCTCAAACGTACGTGGTTTCAGTCGGTGCGCTTCCCAACCTGGTCTG
seq140_cluster7	TGATCGGGTGGCTTAATTTATCGCCCGCCTTATCGCGGCTGAATCGCAATACGCGTTCTACGGTATTCATTTAGCGCAGCCTGGACACCAAGAGATTAGCTTGGCGATGCCTCAAGGGCTAGTGCGAAACTAACGAGAACAACTCGCTTTTT
seq141_cluster7	TGATCGGGTGGCTTAATTTTACGCCCGCTTTATCGTGGCTGAATCGCAATACGAGTTCTACGCTATTCATTTTGCGCACCCTGGACACCAAGAAGTTAGTTTGGCGATGCCTCCAGGGCTAGTGCGAAACTAACGACAACAACTAGCTTTTT
seq142_cluster7	GGATCGCGTGGCTTAATTTTTCGCCCGCCTTATCGCGGCTAAATCGCAATGCGAGTGCTACGCCATTCAATTTGCGCACCCTAGACACCAGGAGATTAGTTTGGCGATTCCTCCAGGGTTAGTGCGAAACTAAGGAGAACAACTAGCTTTTT
seq143_cluster7	TGATCGCGTTGCTTAATTTTACGCCCGCCTTATCGCGGCTGGATCGCAATACCAGTTCTACGCTATTCATTTTGCGAACCCTGGACACCAAGAGATTAGTTTGGCGATGCCTCGAGGGCTAATAGGAAACTAACGAGAACAGCTAGCTTTTT
seq144_cluster7	TGATCGCGTGGCTTAATTTTTCGCCCGCCTTATCGCGGCTGAATCGCAATACGAGTTCTACGCTATTCATTTTGCGCACCCTGGACACCAAGAGATTAGTTTGGAGATGCCCCCAGGGCTAGTGCGAAACTAACGAGAACAACTAGCTTTTT
seq145_cluster7	TGATCGCGTGGCTTAGCTTTTCGCCCGCCATATCGCGGCTGAATCGCACTACGAGTTCTACGCTATAGACTTTGCGCACCCTCGACACCAAGAGATGATTTTGGCCATGCCTCCAGGGCTAGTTTGAAGCTCACGAGAACAACTAGCTTTTG
seq146_cluster7	TCATCGCGTGGCTTAATTTTTCGCCCGCCTTATCGCGGCTGAATCGCAATACGAGTTCCACGCTATTCATTTAGCGCACCCGGGAAACCAAGAGAGTAGTTTGCCGATGCCTCCAGGGCTAGTGCGAAACTAACGAGAACAATTAGCTTTTT
seq147_cluster7	TGATTGCGTGGTTTAATTTTTCGCCCGCCTTATCGCGGCTGAGTCGCAATACGAGTTCTACGCTATTCATTCTACGCACCCTGTACACCAAGAGATTAGTTTGGCGATGCCTCCAGGGCTAATGCGAAACTAACGAGAACAACCAGCTTTTT
seq148_cluster7	TGATCACTTGGCTGAATTTTTCCCCCACCTTGTCGCGGCTGAATCGCAATATGATTTCTACGCTATTCATTTTGCGCCCCCTGGACACAAAATGATTATTTTGGCGATGCCTCCAGGGCTAGTGCGAAGCTCACGAGTGCGAAGAGCTTTGT
seq149_cluster7	TGATCGCTTGGCTTAATTTTTCGCCCGCCTTATCGCGGCTGAATCGCAAGACGAGTTCTACGCTATTCATGTTGCGCAACCTGGACGCCAAGAGATTAGTTTGGCGATGCCTCCAGGGCTAATGCGCAACTAACGAGAACAACTATCTTTTT
seq150_cluster7	TGATCGCGTGGCGTTATTTTTCGCCTGCCTTATCGCGGCTGAATCGCAATACGAGTTCTACGCTATTCATTTTGCGCACCCTGGACATCAAGAGATTAGTTTGGCGAGGCCTGCAGGGCTTGTGCGAAACTAACGAGAACAACTAGCTTTTT
seq151_cluster7	TGATCGCGTTGCTTAATTATTCGCCCGCCTAATCGCGGCTGAATTGCAATATGAGTTCTACGCTATTCATTGTGCTCACCCTGGACACCACGGGATTACTTTGGCGATGCTTCCAGGGCTAGTGCGAAACTAACGAGAATAACTAGCTTTTT
seq152_cluster7	TGATCGCGTGGCTTAATTTTTCGCCGACCTTATCGCGGCTGAATCGCAATCCGAGTTCTACGATATTCATCTGGCGCACCTTGGACACCAAGATATTAGTTTGGCGATGCTTCCCGCGCTAGAGCGAAACTAACGAGAACCACTAGCTTTTT
seq153_cluster7	TGAGCGCGTGGCTTAATTTTTCGCCCGCCTTATCGCGGCTGAATCGCCATACGATTTCTACGCCATTCCTTTAGCGCACCCTGAACACCAAGAGATTAGTTTGGCGATGCCTCCAGGGCTAGTGCGAAACTAACCAGAACAACTAGCTTTTT
seq154_cluster7	TGATCGCGTGGCTTAATTTTTCGCCCGCCTTAGCGCGGCTCAATCGCAATACGAGTTCTACGCTATTCATTTTGCGCACTCTGGACACCAAGAGATTAGTTTGGCGATGCCTACAGGACTAGTGCGAAACTAACGCGAACAACTAGCTTTTT
seq155_cluster7	TGATCGCGTGGCTTAATTTTTCGCCCGCCTTATCGCGGCTGAATCGCAATACGAGTTCTACGTTATTCATTTTGCGCACCCTGGACACCAAGAGATTAATTAGGCGATGCCTCGAGGGCTAGTGCTAAACTAACGAGAACAACTAGCTTTTT
seq156_cluster7	TGATCGCGTGGCTTAATTTTTCGCCCGCCTTATCGCGGCTGAATCGCAATACGAGTTCTACGCTATTCATTTTGCGCACCCTGGACACCAAGAGATTAGTTTGGCGATGCCTCCAGGGCTAGTGCGAAACTAACGAGAACAACTAGCTTTTT
seq157_cluster7	TGAAGGCGTGCCTTAATTTTTGGCCCGCCTGTTCACGGCTGAATCGCAATAAGAGTTCTACGCTATGCGTTTCGGGAAGCCTGGATACCAAAAGATTAGTTCGGCGATGCCTCCAGCCCTAGGGCGAAACTAACGACTACAACTAGCTTTTT
seq158_cluster7	TGATCGCGTGGCTTAATTTTTCGCCCTCCTTATCGCGGCTGAATCCCAATACGAGTTCTACGCTATTCATTTTGCGCACCCTGGGCACCAAGAGATTAGTTTGGCGATACCTCCAGGGCTAGTGCGAAACAAACGATAACAACTAGCTTTTT
seq159_cluster7	TGATCGCGTGGCTTAATTTTTCGCCCGCCTTATAGCGGCTGAATCGCAATACGAGTTCTACGCTATTCACTTTGCGCACCCTGGACACCAAGAGATTAGTTTAGAAATGCCTCCAGGGCTAGTGCGAAACTAACGAGAACAACTAGCTTTTT
seq160_cluster8	GGCAAGGACATGTCGGCCGACCCATACGTCCCGCCGAAGTCATAGGTCTTTCTGTGGTATCAGACTCGTTCCGTGAGAAAACAATATCAACCGCACTATGCTGGCCAGAATGTAAGTTTTGCGCTGTATTAGTTGCTCCCGATCTAGTGCGA
seq161_cluster8	GACAGTGACATGGCGTCCGACCCATACGTCCCGCCGAAGTCATAGATCTTTCTGTGGTATCACACTCGTTCCGTGAGAAAACAATACCAACCGCACTATTCTGGCCAGAATGTAAGTTTTGCGGTGTTGTAGTTGGTCCCGATTTAGTGCGA
seq162_cluster8	GACACTGACATGGCGGCCGACCCATACGTGCCGCCGAAGTCATACGTATTCCTGTGGTATGACACTCGTGCCGTGAGAAAACAATATCAACCGCACTAATCTGGCCATAATATAAGTTTTGCGCTGTTGTAGTTGGTCCCGATTTAGTGCGA
seq163_cluster8	GACAATGACATGGCGGCCGACCCATACGTCCCGCCGAAGTCATAAGTCTTTCTGTGGTATCACACTCGTTCCGTGAGAAAACAATATCAACCGCACTAATCTGGCCAGAATGTAAGTTTTGCGCTGTTGTAGTTGGTCCCGATTTAGTGCGA
seq164_cluster8	GACAATTAGATGGCGGCCGACCCAAACCTCCGGCCGAACCCATAGGTATTTCTGTGATATCACACTCGTTCCGTGAGAAAACAATGTCAACCGCACTATTCTGGCCAGAATGTAAGTGGTGCGCTGTTATAGCTGATCCCGATTTAGTGCGA
seq165_cluster8	GACAATGAAATGGCGGCCGACCCATACGTCCGGCCGAAGTCATAGGTCTTTCTGTGGTATCACACTCGTTCCGTGAGAAAACAATAGCAACCGCACTAATCTGGCCAGAATGTAAGTTTTGCGCTGTTGTAGTTGGTCCCGATTTAGTGCGA
seq166_cluster8	GACAATGACATGGCGGCCGACACGGACGACCTGCCGAAGTCATAGGTCCTTCTGCGGTATCAGACTCGTTCCGTGAGAAAACAATAGCAACCGCACAATTCTGGCTAGAATTTAAGGTTTGCGCTGTTGTAGTTGGTCCCGTTTCAGTGCGA
seq167_cluster8	GACAATGACATGGCGGCCGACCCATGCGTCCCGCCGAAGTCATAGGTCTTTCTGTAGTATCACACTCGTTCCGTGAGAAAACAATATCAACCGCACTATTCTGGCCAGAATGTAAGTTTTGCGCTGTTGTAGTTGGTCCCGATTTAGTGCGA
seq168_cluster8	GACAATGACATGGCGGCCGACCCATACGTCCCGCCGAAGTCATAGGTCTTTCTGTGGTGTCACACTCGTTCCGTGAGATAACAATATCAACCGCACTATTCTGGCCAGAATGTAAGTTTTGCGCTGTTGTAGTTGGTCCCGATTTAGTGCGA
seq169_cluster8	GACAATGACACGGCGGCCGACCCATGCGTCCCGCCGAAGGCATAGGTCTTTCTGTGGTATCACACTCGTTCCGTGACAAAACAATATCAACCGCACTATTCTTGCCAGAATGTAAGTTTTGCGCTGTTGTAGTTGGTCCCGATTTAATGCGA
seq170_cluster8	GACATTGACATGGCGGCCGAACCATACGTCCCGCCGAAGTCATAGGTCATTCTGTGGTATCACACTCGGTCCGTGAGAAAACAATATCAACCGCACTATTCTGGTTAGAATGTAAGTTTTGCGCTGTTGTAGTTGGTCCCGATTTAGTGCGA
seq171_cluster8	GACAGTGACATGGCGCCCGACCCATACGGCCCGCCGAAGTCATAGGTCTTTCTGTGGTATCACACTCGTTCCGTGAGATAACAATATCAACTGCACTATGCTGGCCAGAATGAAAGTCTTGGGCTGTTGTAGTCGGTCCCGCTTTAGTGCGA
seq172_cluster8	GACAATGACATGGCAGCCCACGCATTCGTTCCGCCGAAGTCACAGGTCTTTCTGTGGTATCACACCCGTTCCGTGGGAAAACAATATCAACCGCACTATTCTGGCCAGAATGTGAGTTTTGCGCTGTTGTAGTTGATCCCGATTTAGTACGA
seq173_cluster8	GACATTGACATGGCGTCGGACCCATACGTCCCGCCGAAGTCATACGTCTTTCTGTGGTTTCACACCCGTTACGGGTGGAGACAATTTCCAACACACTATTTTGGCCAGAATGTAAGTTTTGCGTGGTCGTAGTTGGCCCCGATTTAGTGCGA
seq174_cluster8	GACAATGCCATGTCGGCCGAACCATACGTCCCTCCGCAGTCACAGGTCTTTCTGTGGTATCACACTCGTTCCGTGAGAAAACAATATCAACCGCACTATTCTGGCCTGAATGTAAGTTTTGCGCCGTTGTAGTTGGTCGGGATTTAGTGCGA
seq175_cluster8	GACAATGACATGGCGGCCGACCCATACGTCCCGCCGAAGTCATAGGTCTTTCTGTGGTATCACACTCGTTCCGTGAGAAAACAATATCAACCGCACTATTCTGGCCAGAATGTAAGTTTTGCGCTGTTGTAAGTGGTCCCGATTTAGTGCGA
seq176_cluster8	GACAATGACATGGCGGCCGACCCATACGTCCCGCCGAAGTCATAGGTCTTTCTGTGGTATCACACTCGTTCCGTGAGAAAACAATATCAACCGCACTATTCTGGCCAGAATGTAAGTTCTGCGCTGTTGTAGTAGGTCCCGATTTAGTGCGA
seq177_cluster8	GATATTGACATGGCGGCCGACCCATACGTCCCGCCGAAATCATAGTTCTTTCTGTGGTATCACACTCGTTCCGTGAGAAAAGAATATTAACCGCATTATTCTGGCCAGAATATAAGTTTTGCGCTGTTGAGGTTGGTCCCGATTTAGTGCGA
seq178_cluster8	TACAATGACAGGGCGGCCGACCCAAACGTCCCGCCGAAGTCATAGGTCTTTCTGTGGTATAACACTCGTTCCGTGAGAAGACAATATCAACGGCACGATACTGGCCAGAATGTAAGTTTTGCGCTCTTGTAGTTGGTCCCGATTTAGCGCGA
seq179_cluster8	GACAATGACATGGCGGCCGACCCATACGTCCCGCCGAGGTCATAGGTCTTTCTGTGGTATCACACTCGTTCCGCGAGAAAACTATATCAACCGCACTATTCTGGCCAGAATGTAAGTTTTGCGCTGTTGTAGTTGGTGCCGATTTAGTGCGC
seq180_cluster9	CGCTTGGAAACGTTCCACAGCGCGCACGCGCATTGACTGTCATGCATGCCACTTCTAGGGACGCATTGGATTCATCCAGCGCACTTTATCTTTCGTCGACCAGTGCACAAAAGCCAGTACCTGCCTTGCTAGTTGGGTGGTCACCTCGGTGG
seq181_cluster9	CGCTTGGAAAAGTTCCACAGCGCGCACGCGCAATGACTGTCGTGCATGCCACTTCTAGGGACGCATTGGATTCATCCAGCGCACTTTATCTTTCGTCGACCAGTGCACATAAGCCAGTACCTGCCTTGCTAGTTGGGTGGTCACCTCGGTGG
seq182_cluster9	CGCTTGGAAAAGTTCCACAGCGCGCACGCGCATTGACTGTCGTGCATGCCACTTCTAGGGACGCATTGGATTCATCCAGCGCACTTTATCTTTCGTCGACCAGTGCACAAAAGCCAGTACCTCCCTTGCTAGTTGGGTGGTCACCTCGGTGG
seq183_cluster9	CGCTTGGAAGAGTTCCACAGCGCGCACGCGCATTGACTGTCGTGCATGCCACTTCTAGGGACGCATAGGATTAATCCAGCGCACTTTATCTTTCGTCGTCCAGTGCACAAAAGCCAGTACCTGCCTTCCTAGTTGGGTGGTCACCTTGGTGG
seq184_cluster9	CGCTTGGAAAAGTTCCACAGCGCGCACGCTCATTTACTGTCATGCATGGCACTTCTAGGGACGCATTGGGTTCATCCAGCGCACTTTATCTTTCTTCGACCAGTGCACAAAAGCCAGTACCTGACTTGCTAGCTGGGTGGTCACCTCGGTGG
seq185_cluster9	CGCTTGGAAAAGTTCCACAGCGCGCACGCGCATTGACTGTCGTGCATGGCACTTCTAGGGACGCATTCGATTCATCCAGCGCACTTTATCTTTCGTCGACCAGTGCACAAAAGCCAGTACCTGCCTTGCTAGTTGGGTGGTCACCTCGGTGG
seq186_cluster9	CGCTTGGAACAGTTCCACAGCGCGCACGCGAATTGACTGTCGTGCATGCCACTTCTAGGGACGCATTGGATTCAGCCAGCGCACTTTATCTTTCGTCGACCAGTGCACAAAAGCCAGTACCTTCCTTGCTAGTTGGGTGGTCCCCTCGGTGG
seq187_cluster9	CGCTTCGAAAAGTTCCACAGCCCGCACGCCCATTGACTGTCGAGCATGTCACTTCCAGGGACGCATTGGATTCATCCAGCGCACTTAATCCTTCGTCGACCAATGCACAAAAGCCAGCACCTGCCTAGCTAGTTGGGAGGTTACCGCGGTGG
seq188_cluster9	CGCTTGGAAAAGTTCCACAGCGCGCACGCGCATTGACTGTCGTGCATGCCACTTCTAGGGACGCATTGGATTCATCCAGCGCACTTTATCTTTCCTCGCCCAAAGCACAAAAGCCAGTACTTGCCTTGCTAGTTGGGTGGTCACCTCGGTGG
seq189_cluster9	CTCTTGGAAAAGTTCCACAGCGCGCAGGCGCATTGACTGTCAAGCATGCCACTTCTAGTGACGCACTGGATTGATCCAGCGCACTTTATCTTTCGTCGACCAGTGCACAAAAGCCAGTTACTGCCTTGCTAGTTGGGTGGTCACCTCGGTGG
seq190_cluster9	CGCTTGGAAAAGATCCACAGAGCGCACGCGAAGTGACTGTCGTGCATGCGACTTCTAGGGACGCATTGGATTCAGCCAGCGCACTTTATCTTTCGTCGACCAGTGCACAAAAACCAGTACCTGTCTTGCTAGTTGAGTGCTCACCGCGTTGG
seq191_cluster9	CGCTTGGAAAAGTTCCACAGCGCGCACGCGCTTTGACTGTCGTGCATGCTACTTCTAGGGACGCATTGGATTCATCCAGCGCACTGTATCTTTCGTCGACCAGTGCACAAAAGCCAGTACCTGCCTTGCTAGTTGGGTGGTCACCTCAGTGG
seq192_cluster9	CGCGTGGAAAAGTTCCACAGCGCGCACGAGCATTGACTGTCGTGCATGCCACTTCTAGGGGAGAATTGGATTGATCCAGCGCACTTTATCTTTCATCGACCAGCGCACAAAAGCCAGTACCCGCCTAGCTAGTTGGGTGGTCACCTCGGTCG
seq193_cluster9	CGCTTGGAAAAGTTCCACAGCGCGCAGACGCATCGACTGTCGTGCATGCCTCTTCTAGGGACGCATTACATTCCTCCAGCTCACTTTATCTTTCGTTGACCAGTGCACTAAAGCCAGTACCTGCCTTGCTAGTTGGGTGGTCACCTCAGTGG
seq194_cluster9	CGCTTTAAAAAGATCCACAGCGCGCACGCGCATTGACTGATGTGCATGCCACTTATAGGGACGCATTGGATTAATCCAGCACACTTTATCTTTAGTCGACCAGTGCTCAAAAGCCAGTACCAGCCTTGCTAGTTGGCTGGGCACCTCGGGGG
seq195_cluster9	CGCTTGGAAAAGTTCTACAGCGCGCACGCGCATTGACTGTCGTGCATGCCACTTCTAGGGACGCATTGGATTCATCCAGCGCACTTTACCTTTCGTCGACCAGTGCACAAAAGCCAGTACCTGACTTGCTAGTTGGGTGGTCACCTCGGTGG
seq196_cluster9	CGCTCGGAAAAGTTCCTCAGCGCGCACGTGCATTGACTGTCGTGCATGCCTCTTATAGGGACTAATGGGATTCAACCAGCGCACTTTATGATTCGTAGACCAGTGCACAAAAGCCAGTACCTGCCTTGCTAGTTGGGTGGTCACCTCGGTAG
seq197_cluster9	AGCTTGGAAAAGTTCCACAGCGCGCACGCGCATTGACTGTCGTGCATGCCACTTCTAGGGTCGCATTGGATTCATCCAGCGCACTTTATCTTTCGTCGACCAGTGCACAAAAACCAGTACCTGCCTTGCTAGTTGGTTGGTCACCTCGGTGC
seq198_cluster9	GGCTTGGAAACGTTCCACGGCGCGCACCCGCATTGAATGTCGGGTATGCCGCTTCGAGGGACCCATTTGATCCATCGAGCGCACTTTCTCTTTCGTCGACCAGTGCAAAAAAGCCAGTACACGCCTTGCTCGAGGGGTAGTCACCTCGGAGG
seq199_cluster9	CGCTTGGAAAAGTTCCACAGCGCGCACGCGCATTGACTGTCGTGCATGCCACTTCTAGGGAAGCATTGGATTCATCCAGCGCACTTTATCTTTCGTCGACCAGTGCACAAAAGCCAGTACCTGCCTTGCTAGTTGGGTGGTCACCTCGGTGG
